



NO ./includes/assets/IMG_1.xpm
SO ./includes/assets/IMG_2.xpm
EA ./includes/assets/IMG_3.xpm
WE ./includes/assets/IMG_4.xpm



C  50,50,50


F  102,102,51





                         111111111111111111111111111111111111
                         100000000000000010000000000000000011
                         100000000000000010111111111111111001
11111111111111111111111111000000000000000111111111        101
  1E00000000000D0000000000000000000000000101              101
11111111111111111111111111000000000000000101       1111111101
                         100000000000000010111111111111111101
                         100000000000000010000000001111101101
                         100000000000000000000011100000000001
                         111111111111111111111111111111111111
