



NO ./includes/assets/IMG_1.xpm
SO ./includes/assets/IMG_2.xpm
EA ./includes/assets/IMG_3.xpm
WE ./includes/assets/IMG_4.xpm



C  0,0,102


F  0,102,51





1111111111111111111
10000000000000000011
10111111111111111001
101              101
101              101
101       1111111101
10111111111111111101
10000000001111101101
10000011100000N00001
11111111111111111111
