



NO ./path123
SO ./path_here
EA                    ./path_to_the_east_texture

WE               ./path_to_the_west_texture



C         255,20,30


F                  10,20,30





1111111111111111111
10000000000000000011
11111111111111111001
1                101
1                101
1       000      101
111111111111111111011
10000001011111101101
1000001 100000N00001
1111111111111111111