



NO ./path123
SO ./path_here
EA                    ./path_to_the_east_texture

WE               ./path_to_the_west_texture



C         255,20,30


F                  10,20,30





1111111111111111111
10000000000000000011
10111111111111111001
101              101
101              101
101              101
10111111111111111101
10000000001111101101
10000011100000N00001
1111111111111111111