



NO ./path123
SO ./path_here
EA                    ./path_to_the_east_texture

WE               ./path_to_the_west_texture



C         255,20,30


F                  10,20s,30





1111111111111111111
1000000000000000001
1111111111111111101
1          0     101
1111111111111111101
1000000101111111101
1000001 100000N00001
1111111111111111111