NO ./includes/assets/IMG_1.xpm
SO ./includes/assets/IMG_2.xpm
EA ./includes/assets/IMG_3.xpm
WE ./includes/assets/IMG_4.xpm



C         255,20,30


F                  10,20,30


1111
10N1
1111