



NO ./includes/assets/IMG_1.xpm
SO ./includes/assets/IMG_2.xpm
EA ./includes/assets/IMG_3.xpm
WE ./includes/assets/IMG_4.xpm



C  60,130,102


F  50,50,50





1111111111111111111
10000000000000000011
1000000001111111100111111
1011110001       10011111
101  10001       100000001
101   11111111111101111001
10111111111111111101111001
100000000011111011011110011
10000011100000N000000000001
111111111111111111111111111
