



NO ./includes/assets/IMG_1.xpm
SO ./includes/assets/IMG_2.xpm
EA ./includes/assets/IMG_3.xpm
WE ./includes/assets/IMG_4.xpm



C  50,50,50


F  0,102,51





111111111111111111111111111111111111
10000000000000001000000000000000001
100000000000000010111111111111111001
1000000000000000111111111        101
1000000000000000101              101
1000000000000000101       1111111101
1000000000000000101111111111111111D1
100000000000000010000000001111101101
100000000000000000000011100N00000001
11111111111111111111111111111111111
